s0000010000
11100111110
11010111110
11110111110
11110000010
1111000100e
